0 0 0 0 0 0 0 0 0 0 0 0 0 0 0 0 
0 0 0 0 0 0 0 0 0 0 0 0 0 0 0 0 
0 7 7 7 7 7 7 7 7 7 7 7 7 7 0 0 
0 7 7 7 7 7 7 4 7 7 7 7 7 7 0 0 
0 7 7 7 7 7 4 4 4 7 7 7 7 7 0 0 
0 7 4 4 4 7 7 4 7 7 4 4 4 7 0 0 
0 7 7 7 4 4 7 4 7 4 4 7 7 7 0 0 
0 7 7 4 4 4 4 4 4 4 4 4 7 7 0 0 
0 7 7 7 7 4 4 4 4 4 7 7 7 7 0 0 
0 7 7 7 4 4 7 4 7 4 4 7 7 7 0 0 
0 0 7 7 7 4 7 4 7 4 7 7 7 0 0 0 
0 0 0 7 7 4 7 4 7 4 7 7 0 0 0 0 
0 0 0 0 7 7 7 4 7 7 7 0 0 0 0 0 
0 0 0 0 0 7 7 7 7 7 0 0 0 0 0 0 
0 0 0 0 0 0 7 7 7 0 0 0 0 0 0 0 
0 0 0 0 0 0 0 7 0 0 0 0 0 0 0 0
