0 0 0 0 0 0 0 0 0 0 0 0 0 0 0 0 
0 0 0 0 0 0 0 0 0 0 0 0 0 0 0 0 
0 7 7 7 7 7 7 7 7 7 7 7 7 7 0 0 
0 7 7 7 7 7 7 4 7 7 7 7 7 7 0 0 
0 7 7 7 7 7 4 4 4 7 7 7 7 7 0 0 
0 7 4 4 4 7 7 4 7 7 4 4 4 7 0 0 
0 7 7 7 4 4 7 4 7 4 4 7 7 7 0 0 
0 7 7 4 4 4 4 4 4 4 4 4 7 7 0 0 
0 7 7 7 7 4 4 4 4 4 7 7 7 7 0 0 
0 7 7 7 4 4 7 4 7 4 4 7 7 7 0 0 
0 0 7 7 7 4 7 4 7 4 7 7 7 0 0 0 
0 0 0 7 7 4 7 4 7 4 7 7 0 0 0 0 
0 0 0 0 7 7 7 4 7 7 7 0 0 0 0 0 
0 0 0 0 0 7 7 7 7 7 0 0 0 0 0 0 
0 0 0 0 0 0 7 7 7 0 0 0 0 0 0 0 
0 0 0 0 0 0 0 7 0 0 0 0 0 0 0 0

2 2 2 2 2 2 2 2 2 2 2 2 2 2 2 0 
2 2 2 2 2 2 2 4 2 2 2 2 2 2 2 0 
2 2 2 2 2 2 4 4 4 2 2 2 2 2 2 0 
2 2 2 4 4 2 2 4 2 2 4 4 2 2 2 0 
2 2 4 4 4 4 2 4 2 4 4 4 4 2 2 0 
2 4 4 2 2 4 4 4 4 4 2 2 4 4 2 0 
2 4 2 2 2 2 4 4 4 2 2 2 2 4 2 0 
2 4 4 2 2 2 2 4 2 2 2 2 4 4 2 0 
2 2 4 4 2 2 2 4 2 2 2 4 4 2 2 0 
0 2 2 4 4 2 2 2 2 2 4 4 2 2 0 0 
0 0 2 2 4 4 4 4 4 4 4 2 2 0 0 0 
0 0 0 2 2 4 2 2 2 4 2 2 0 0 0 0 
0 0 0 0 2 4 4 4 4 4 2 0 0 0 0 0 
0 0 0 0 0 2 2 2 2 2 0 0 0 0 0 0 
0 0 0 0 0 0 2 2 2 0 0 0 0 0 0 0 
0 0 0 0 0 0 0 2 0 0 0 0 0 0 0 0

4 4 4 4 4 4 4 4 4 4 4 4 4 4 4 0 
4 4 4 4 4 4 7 7 7 4 4 4 4 4 4 0 
4 4 7 4 4 4 7 7 0 7 7 4 7 4 4 0 
4 7 7 7 4 4 7 7 7 4 4 7 7 7 4 0 
4 7 7 7 7 7 7 7 7 7 7 7 7 7 4 0 
4 7 7 0 7 7 7 7 7 7 7 0 7 7 4 0 
4 7 7 7 7 0 7 7 7 0 7 7 7 7 4 0 
4 7 7 7 7 7 7 7 7 7 7 7 7 7 4 0 
4 7 4 7 4 7 0 7 0 7 4 7 4 7 4 0 
0 7 4 4 4 4 7 7 7 4 4 4 4 7 0 0 
0 0 4 4 4 4 7 7 7 4 4 4 4 0 0 0 
0 0 0 4 4 7 7 7 7 7 4 4 0 0 0 0 
0 0 0 0 4 7 4 4 4 7 4 0 0 0 0 0 
0 0 0 0 0 4 4 4 4 4 0 0 0 0 0 0 
0 0 0 0 0 0 4 4 4 0 0 0 0 0 0 0 
0 0 0 0 0 0 0 4 0 0 0 0 0 0 0 0

6 6 6 6 6 6 6 6 6 6 6 6 6 6 6 0 
6 6 6 6 6 6 6 6 6 6 6 6 6 6 6 0 
6 6 5 5 5 5 6 6 6 5 5 5 5 6 6 0 
7 7 5 5 5 5 7 7 7 5 5 5 5 7 7 0 
6 6 5 5 5 5 6 6 6 5 5 5 5 6 6 0 
6 6 5 5 5 5 6 6 6 5 5 5 5 6 6 0 
7 7 5 5 5 5 7 7 7 5 5 5 5 7 7 0 
6 6 5 5 5 5 6 6 6 5 5 5 5 6 6 0 
6 6 6 5 5 5 5 6 5 5 5 5 6 6 6 0 
0 6 6 6 5 5 5 5 5 5 5 6 6 6 0 0 
0 0 6 6 6 5 5 5 5 5 6 6 6 0 0 0 
0 0 0 6 6 6 5 5 5 6 6 6 0 0 0 0 
0 0 0 0 6 6 6 5 6 6 6 0 0 0 0 0 
0 0 0 0 0 6 6 6 6 6 0 0 0 0 0 0 
0 0 0 0 0 0 6 6 6 0 0 0 0 0 0 0 
0 0 0 0 0 0 0 6 0 0 0 0 0 0 0 0
