6 6 6 6 6 6 6 6 6 6 6 6 6 6 6 0 
6 6 6 6 6 6 6 6 6 6 6 6 6 6 6 0 
6 6 5 5 5 5 6 6 6 5 5 5 5 6 6 0 
7 7 5 5 5 5 7 7 7 5 5 5 5 7 7 0 
6 6 5 5 5 5 6 6 6 5 5 5 5 6 6 0 
6 6 5 5 5 5 6 6 6 5 5 5 5 6 6 0 
7 7 5 5 5 5 7 7 7 5 5 5 5 7 7 0 
6 6 5 5 5 5 6 6 6 5 5 5 5 6 6 0 
6 6 6 5 5 5 5 6 5 5 5 5 6 6 6 0 
0 6 6 6 5 5 5 5 5 5 5 6 6 6 0 0 
0 0 6 6 6 5 5 5 5 5 6 6 6 0 0 0 
0 0 0 6 6 6 5 5 5 6 6 6 0 0 0 0 
0 0 0 0 6 6 6 5 6 6 6 0 0 0 0 0 
0 0 0 0 0 6 6 6 6 6 0 0 0 0 0 0 
0 0 0 0 0 0 6 6 6 0 0 0 0 0 0 0 
0 0 0 0 0 0 0 6 0 0 0 0 0 0 0 0
